TTTTTTTTTTTTTTTTTTTTTTTTTTTTTTTTTTTTTTTT
TODTTDTOODTDDDOTODDODDDDTDDDODDDDDOTDVDT
TDDPTDVDODTDDDTTTDDTDODDDDODDODODDDTDTOT
TDDDDTDDOVDDODDDDTDDDDDODTTODDDDDDDTDTTT
TVDTDDTOTODDODDDDTDDDODDDDDDODOODDDDDDTT
TODTDDDTDDODTTDDODTTVDDDDDDDODOODDDDDDTT
TOODDODDDDTDDDODDDDDDODOODDDDDDODDVTTDDT
TDDODTTDDODOODDDTDDDDODOODDDDDDTDDODTDOT
TDDTDDDVDDDDDDVDODDTTODDODTDTODDTODDVDOT
TODODDDDTDTTDDVDODDTTODDODDVDTDDDTDDODTT
TDODTTDDDDDOOTODDVDTDTODDTODDDTODDVDODDT
TTDTTDDDDDDOOTODDODTDTTDDDTDDODTTDDODTTT
TDTDODODTDDDTTODDODDDDTDDDODDDDDTTDODTTT
TDTDODODTDVDTDTODDTODDDDODDODOODDDDTDDDT
TTDDTOTODDODDDDTDDDVDDDTDOTDDDDDDTDTTDVT
TTDDDTTODDTDVDDDTODDODODDDODTODDDDDDTDDT
TTDVDDDDODTTDDODTTODDDDDDDODTODDDDDDTDDT
TDDODDDDTDDDODDDDDDODOODDDDDDTDDODTDDDTT
TODTTDDODTTDDDTDDDDODOODDDDDDTDDOVDDODDE
TTDDDODDDDDDODOVDDDDDDODDDTTDDTODDVDTDDT
TOODDDTDDDDDODOVDDDDDDTDDODTVDVDOTDODDDT
TTTTTTTTTTTTTTTTTTTTTTTTTTTTTTTTTTTTTTTT