TTTTTTTTTTTTTTTTTTTTTTTTTTTTTTTTTTTTTTTT
TDODDODDTDODDDVDTDDD9DODT9DDDDDDTDDOODDT
TDDDDDDDTDDDDDD9T99D9DDDT9DD9DDDTDDDD9DT
T99999999999999O9OO999999O99V99999999O9T
TVDDDDDDTDODDDDOTDOD9DD9TDDODDVDTDDODODT
TDDDDDDDTDODDDDOTDOD99DDTDDDDDODTDDD9DDT
TTTTTTTTTTTTTTTTTTTT9TTTTTTTTTTTTTTTTTTT
TDDDDOODTDD9DDDDTDDD9DDOTDDDD9DDTDDDDD9T
TDDDDDDDTDD9DDDDTDDD9DDDTDDDDOD9TDDDDDOT
T9999999999O99999999999999999O99999999OT
TODDODDDTDDDDODDTDDO9DDDTDDDDDDVT9DDDDDT
TODDDDODTDDODDODTDDD9D99TDDDDDDDTODDDODT
TDODDDDDTDDDODDDTDDD9DOOTDDDDDDDTOODDODT
TTTTTTTTTTTTTTTTTTTT9TTTTTTTTTTTTTTTTTTT
TOD99XDDTDDDDODOTDDD9DDDTDOVDDODTDDDDDDT
TDDDDD9DT9DDDDDDTDD99DDDT9DD9DDDTD9D99DT
T99999999O999999999V99999999O99999O9OO9T
TVDD9DODTODDDDODTDOF9DDOTDODODDDTDDDDDDT
TDDDDDODTODDVDDDTDDDO9DDTDDODDDDTDDDO99T
TDVDDDO9TDD9DDDDTDPVOODDTD9DDDDDTDDDOO9T
TDODDDDOTDDODDODTDEDODDDTDDDDODOTDDDDODT
TTTTTTTTTTTTTTTTTTTTTTTTTTTTTTTTTTTTTTTT
2
3