TTTTTTTTTTTTTTTTTTTTTTTTTTTTTTTTTTTTTTTT
TPOZOZVZOZVZOZVZOZVZOZVZZZZZZZZZZZZZZZZT
TZZZDZDZDZDZDZDZDZDZOZVZZZZZZZZZZZZZZZZT
TZZZMZMZVZOZVZOZVZOZOZVZZZZZZZZZZZZZZZZT
TZZZZZZZDZDZDZDZDZDZOZVZZZZZZZZZZZZZZZZT
TZZZTZTZMZMZMZMZOZVZOZVZZZZZZZZZZZZZZZZT
TZZZZZZZZZZZZZZZDZDZOZVZZZZZZZZZZZZZZZZT
TZZZZZZZZZZZDZDZMZMZOZVZZZZZZZZZZZZZZZZT
TZZZZZZZTZTZZZZZZZZZOZVZZZZZZZZZZZZZZZZT
TZZZZZZZZZZZZZZZTZTZDZDZZZZZZZZZZZZZZZZT
TZZZZZZZZZZZZZZZZZZZMZMZZZZZZZZZZZZZZZZT
TZZZZZZZZZZZZZZZZZZZZZZZZZZZZZZZZZZZZZZT
TZZZZZZZZZZZZZZZZZZZZZZZZZZZZZZZZZZZZZZT
TZZZZZZZZZZZZZZZZZZZZZZZZZZZZZZZZZZZZTTT
TZZZZZZZZZZZZZZZZZZZZZZZZZZZZZZZZZZyZYZT
TZZZZZZZZZZZZZZZZZZZZZZZZZZZZZZZZZZZZTTT
TZZZZZZZZZZZZZZZZZZZZZZZZZZZZZZZZZZbZBZT
TZZZZZZZZZZZZZZZZZZZZZZZZZZZZZTRTZZZZTTT
TZZZZZZZZZZZZZZZZZZZZZZZZZZZZZRZRZZgZGZT
TZZZZZZZZZZZZZZZZZZZZZZZZZZZZZTRTZZZZTTT
TZZZZZZZZZZZZZZZZZZZZZZZZZZZrrrrZZZrZRZT
TTTTTTTTTTTTTTTTTTTTTTTTTTTTTTTTTTTTTTTT