########################################
#DDDDDDDDDVDODDDDDDODODDDDDDDDDDDDODDDD#
#DOPODDDDDDDDDDDDDDDOVDDODDDDDDDDDDDDDD#
#DDDDDDDDDDDDDDDDDDDODODDODDDDDDDDODDDD#
#ODDDDDDDDDDDDODDDDDDODDODDDDODDDODDDDD#
#ODOODDDDDDDDDOODDODDDDDDDDODDDDDDODODD#
#DDDODDODDDDDDDDODDDDDODDODDDDDDDDODOOD#
#TTTTTTTTTTTTTTTTTTTTTTTTTTTTTTDDDOODOD#
#DDDDOODVDDDDODODDDDDDDDDDVDODDDDDDDODD#
#DDVDDDDDODDDDDDDDDDDDDDODDODDVDDDDODDD#
#DDDODDODODDDDDDDDDDDDDDOODODDODDDDDDDD#
#DDDDDDDODDDDDDDDOODDDDDDDDODDODVDDDDDD#
#DODDDDDODDDDDDDDODOVDDVDDDDODDDODDVDOD#
#DVODDDDDDDDDDDDDDOOODDODDDDDDDDVDDDDDO#
#DDDDDDDDTTTTTTTTTTTTTTTTTTTTTTTTTTTTTT#
#DDDDDDDDDDDDDDDVDDDDODDDDDODDDODDDDDDD#
#DODDDDDDDDDOODDODDDDDDDDODDDDDDODODDDE#
#DODDODDDDDDDDODDDDDODDDDDDDVDDDODOODDD#
#DDDDOVDDDDDDDDDDDODDDDDDODOVDDDDDDODDD#
#DDDDDDDDODDODDODOODDDDDDDDDODOVDDDODDO#
#DVDDDDODDDDDDDDDDDDDDDDDODDODDDDODDDOD#
########################################