TTTTTTTTTTTTTTTTTTTTTTTTTTTTTTTTTTTTTTTT
TPZZOZVZOZVZOZVZOZVZOZVZZZZZZZZZZZZZZZZT
TZZZDZDZDZDZDZDZDZDZOZVZZZZZZZZZZZZZZZZT
TZZZMZMZVZOZVZOZVZOZOZVZZZZZZZZZZZZZZZZT
TZZZZZZZDZDZDZDZDZDZOZVZZZZZZZZZZZZZZZZT
TZZZDZDZMZMZMZMZOZVZOZVZZZZZZZZZZZZZZZZT
TZZZZZZZZZZZZZZZDZDZOZVZZZZZZZZZZZZZZZZT
TZZZZZZZZZZZDZDZMZMZOZVZZZZZZZZZZZZZZZZT
TZZZZZZZDZDZZZZZZZZZOZVZZZZZZZZZZZZZZZZT
TZZZZZZZZZZZZZZZDZDZDZDZZZZZZZZZZZZZZZZT
TZZZZZZZZZZZZZZZZZZZMZMZZZZZZZZZZZZZZZZT
TZZZZZZZZZZZZZZZZZZZZZZZZZZZZZZZZZZZZZZT
TZZZZZZZZZZZZZZZZZZZZZZZZZZZZZZZZZZZZOOT
TZZZZZZZZZZZZZZZZZZZZZZZZZZZZZZZZZZZZDDT
TZZZOZVZOZVZZZZZZZZZZZAZZZZZZZZZZZZZZOOT
TZZZDZDZDZDZZZZZZZZZZZZZZZZZZZZZZZZZZDDT
TZZZZZZZZZZZZZZZZZZZZZZZZZZZZZZZZZZZZOOT
TZZZZZZZZZZZZZZZZZZZTTTZZZZZZZZZZZZZZDDT
TZZZRZYZGZBZRYGBZZZTZFZTZZZZZZZZZZZZZZZT
TZZZZZZZZZZZZZZZZZZTXAWTZZZZZZZZZZZZZZZT
TEZZrZyZgZbZZZZZZZZTZFZTZZZZZZZZZZZZZMZT
TTTTTTTTTTTTTTTTTTTTTTTTTTTTTTTTTTTTTZMT
0
999
10
10