########################################
#DDDDDD]DDVDO]DDDDDODODDDDDDD]DDDDODDDD#
#DOPODDDDDD]DDDDDDDDOVDDODDDD]DDDDD]DDD#
#DDDDDDDDDD]DD]DDDDDODODDODDDDDDDDODDDD#
#OD]]DDDDDDDDDODDDDDDODDODDDDODDDODDDDD#
#ODOODDDDDDDDDOODDODDDDDDDDODDDDDDODO]D#
#DDDODDODDDDDDDDODDDDDOD]ODDDDDDDDODOOD#
#TTTTTTTTTTTTTTTTTTTTTTTTTTTTTTDDDOODOD#
#D]DDOODVD]DDODODDDDDDDDDDVDO]DDDDDDODD#
#DDVDDDDDODDDDD]DDDDDDDDO]]ODDVDDDDODDD#
#DDDODDODODDDDDDDDDDDDDDOODODDODDDDDDDD#
#D]]]]]DODDDDDDDDOO]DDDDDDDODDODVDDDD]D#
#DODD]DDOD]]DDDDDODOVDDVDDDDODDDODDVDOD#
#DVODDDDDDDDDDDDDDOOODDODDDDDDDDVDDDDDO#
#DDDDDDDDTTTTTTTTTTTTTTTTTTTTTTTTTTTTTT#
#]]DDDDDDDDD]DDDVDDDDODDDDDODDDODDDDDDD#
#]ODDDDDDDDDOODDODDDDDDDDODDDDDDODO]DDE#
#DODDODDDDDDDDODDDDDODD]DDDDVDDDODOODDD#
#DDDDOVDD]DDDDDDDDODDDDDDODOVDDDDDDODDD#
#DDD]DD]DODDODDODOODDDDDDDDDODOVDDDODDO#
#DVDDDDODDDDD]DDDDDDDDD]DODDODDDDODDDOD#
########################################