TTTTTTTTTTTTTTTTTTTTTTTTTTTTTTTTTTTTTTTT
T9D9ODD9D9DD9DDOD9DDP9DD9D99DDOD9ODDD9DT
TDODO9DDDDDD9DDODDD9DDDDODDDODDDDDVODODT
E9ODDODDDX9DDDODDODODDODODDDTTTTTTTTTTTT
TDDDVODDOD99DDDDDODDDDD9DDDDDDDD9999DD9T
TTTTTTTTTTTTTDDODODDDD9D99DDDDDDO999DDOT
TD99DDD9D99999DD9D99DDDD9OO9DDDDDOOODDOT
TDDD99DDD999D9DD9D99DDDDDOD9ODD9DODO9DDT
TDDODODDO999DDDDODDDDD9DDD9OODDODDDDODDT
TDDDDDO9DDDDDD9DO99O9D9DDDOOODDODODDDD9T
TODODDD9D99DDDDDDXDDODDD9DDDDODDDDVOD9OT
TDDDDDDODO9DDDDDDDDDOODDODDDTTTTTTTTTTTT
TDOODDDDDDODDOD9DDDVDD9DO9DDOD99DDD9ODDT
TTTTTTTTTTTTTODDDDDDDDODDDODDDDDD9DOODDT
TDD9DDD99DDDVDDOD9DDODOODDDDDDDDD9DOODDT
TDDODDOD9D9DDD99999999DDDDDDDDD999DDODDT
T9DD99DDDDODDO9ODDDV9DD9DDDDDDD99ODDODDT
TODDDODDODODDDOD99DDDDD9999DD9D9DO9DD9OT
TD99DDXDODDDD9D99DDDDDDOO99DDODDDOODDDOT
TODO9DDOD99DDDDDODOD9DDDOOODDODDDDODDDOT
TDDD99DODO9DDDDDODODDDDDOOODDODODDDDODDT
TTTTTTTTTTTTTTTTTTTTTTTTTTTTTTTTTTTTTTTT