########################################
#DDDDDDDDDVDODDDDDDODODDDDDDDDDDDDODDDD#
#DOPODDODDDDDDDDDDDDOVDDODDDDDDDDDDDDDD#
#DDDDDDDDDDDDDDDDDDDODODDODDDDDDDDODDDD#
#ODDDDDDDDDDDDODDDDDDODDODDDDODDDODDDDD#
#ODOODDDDDDDDDOODDODDDDDDDDODDDDDDODODD#
#DDDODDODDDDDDDDODDDDDODDODDDDDDDDODOOD#
#TTTTTTTTTTTTTTTTTTTTTTTTTTTTTTDDDOODOD#
#DDDDOODVDDDDODODDDDDDDDDDVDODDDDDDDODD#
#DDVDDDDDODDDDDDDDDDDDDDODDODDVDDDDODDD#
#DDDODDODODDDDDDDDDDDDDDOODODDODDDDDDDD#
#DDDDDDDODDDDDDDDOODDDDDDDDODDODVDDDDDD#
#DODDDDDODDDDDDDDODOVDDVDDDDODDDODDVDOD#
#DVODDDDDDDDDDDDDDOOODDODDDDDDDDVDDDDDO#
#DDDDDDDDTTTTTTTTTTTTTTTTTTTTTTTTTTTTTT#
#DDDDDDDDDDDDDDDVDDDDODDDDDODDDODDDDDDD#
#DODDDDDDDDDOODDODDDDDDDDODDDDDDODODDDD#
#DODDODDDDDDDDODDDDDODDDDDDDVDDDODOODDD#
#DDDDOVDDDDDDDDDDDODDDDDDODOVDDDDDDODDD#
#DDDDDDDDODDODDODOODDDDDDDDDODOVDDDOEDO#
#DVDDDDODDDDDDDDDDDDDDDDDODDODDDDODDDOD#
########################################