TTTTTTTTTTTTTTTTTTTTTTTTTTTTTTTTTTTTTTTT
TZZZOZVZOZVZOZVZOZVZOZVZZZZZZZZZZZZZZZZT
TZZZDZDZDZDZDZDZDZDZOZVZZZZZZZZZZZZZZZZT
TZZZMZMZVZOZVZOZVZOZOZVZZZZZZZZZZZZZZZZT
TZZZZZZZDZDZDZDZDZDZOZVZZZZZZZZZZZZZZZZT
TZZZTZTZMZMZMZMZOZVZOZVZZZZZZZZZZZZZZZZT
TZZZZZZZZZZZZZZZDZDZOZVZZZZZZZZZZZZZZZZT
TZZZZZZZZZZZDZDZMZMZOZVZZZZZZZZZZZZZZZZT
TZZZZZZZTZTZZZZZZZZZOZVZZZZZZZZZZZZZZZZT
TZZZZZZZZZZZZZZZTZTZDZDZZZZZZZZZZZZZZZZT
TZZZZZZZZZZZZZZZZZZZMZMZZZZZZZZZZZZZZZZT
TZZZZZZZZZZZZZZZZZZZZZZZZZZZZZZZZZZZZZZT
TZZZZZZZZZZZZZZZZZZZZZZZZZZZZZZZZZZZZOOT
TZZZZPZZZZZZZZZZZZZZZZZZZZZZZZZZZZZZZDDT
TZZZOZVZZZZZZZZZZZZZZZZZZZZZZZZZZZZZZOOT
TZZZDZDZZZZZZZZZZZZZZZZZZZZZZZZZZZZZZDDT
TZZZZZZZZZZZZZZZZZZZZZZZZZZZZZZZZZZZZOOT
TZZZZZZZZZZZZZZZZZZZTTTZZZZZZZZZZZZZZDDT
TZZZRZRZZZZZZZZZZZZTDDDTZZZZZZZZZZZZZZZT
TZZZZZZZZZZZZZZZZZZTDADTZZZZZZZZZZZZZZZT
TZZZZZZZZZZZZZZZZZZTDDDTZZZZZZZZZZEZZMZT
TTTTTTTTTTTTTTTTTTTTTTTTTTTTTTTTTTTTTZMT
2
3