TTTTTTTTTTTTTTTTTTTTTTTTTTTTTTTTTTTTTTTT
TPZZOZVZOZVZOZVZOZVZOZVZZZZZZZZZZZZZZZZT
TZZZDZDZDZDZDZDZDZDZOZVZZZZZZZZZZZZZZZZT
TZZZMZMZVZOZVZOZVZOZOZVZZZZZZZZZZZZZZZZT
TZZZZZZZDZDZDZDZDZDZOZVZZZZZZZZZZZZZZZZT
TZZZTZTZMZMZMZMZOZVZOZVZZZZZZZZZZZZZZZZT
TZZZZZZZZZZZZZZZDZDZOZVZZZZZZZZZZZZZZZZT
TZZZZZZZZZZZDZDZMZMZOZVZZZZZZZZZZZZZZZZT
TZZZZZZZTZTZZZZZZZZZOZVZZZZZZZZZZZZZZZZT
TZZZZZZZZZZZZZZZTZTZDZDZZZZZZZZZZZZZZZZT
TZZZZZZZZZZZZZZZZZZZMZMZZZZZZZZZZZZZZZZT
TZZZZZZZZZZZZZZZZZZZZZZZZZZZZZZZZZZZZZZT
TZZZZZZZZZZZZZZZZZZZZZZZZZZZZZZZZZZZZZZT
TZZZZZZZZZZZZZZZZZZZZZZZZZZZZZZZZZZZZZZT
TZZZZZZZZZZZZZZZZZZZZZZZZZZZZZZZZZZZZZZT
TZZZZZZZZZZZZZZZZZZZZZZZZZZZZZZZZZZZZZZT
TZZZZZZZZZZZZZZZZZZZZZZZZZZZZZZZZZZZZZZT
TZZZZZZZZZZZZZZZZZZZZZZZZZZZZZZZZZZZZZZT
TZZZZZZZZZZZZZZZZZZZZZZZZZZZZZZZZZZZZZZT
TZZZZZZZZZZZZZZZZZZZZZZZZZZZZZZZZZZZZZZT
TZZZZZZZZZZZZZZZZZZZZZZZZZZZZZZZZZZZZZZT
TTTTTTTTTTTTTTTTTTTTTTTTTTTTTTTTTTTTTTTT