TTTTTTTTTTTTTTTTTTTTTTTTTTTTTTTTTTTTTTTT
TDDDDDDDDDVDODDDDDDODODDDDDDDDDDDDODDDDT
TDOPODDDDDDDDDDDDDDDOVDDODDDDDDDDDDDDDDT
TDDDDDDDDDDDDDDDDDDDODODDODDDDDDDDODDDDT
TODDDDDDDDDDDDODDDDDDODDODDDDODDDODDDDDT
TODOODDDDDDDDDOODDODDDDDDDDODDDDDDODODDT
TDDDODDODDDDDDDDODDDDDODDODDDDDDDDODOODT
T##############################DDDOODODT
TDDDDOODVDDDDODODDDDDDDDDDVDODDDDDDDODDT
TDDVDDDDDODDDDDDDDDDDDDDODDODDVDDDDODDDT
TDDDODDODODDDDDDDDDDDDDDOODODDODDDDDDDDT
TDDDDDDDODDDDDDDDOODDDDDDDDODDODVDDDDDDT
TDODDDDDODDDDDDDDODOVDDVDDDDODDDODDVDODT
TDVODDDDDDDDDDDDDDOOODDODDDDDDDDVDDDDDOT
TDDDDDDDD##############################T
TDDDDDDDDDDDDDDDVDDDDODDDDDODDDODDDDDDDT
TDODDDDDDDDDOODDODDDDDDDDODDDDDDODODDDET
TDODDODDDDDDDDODDDDDODDDDDDDVDDDODOODDDT
TDDDDOVDDDDDDDDDDDODDDDDDODOVDDDDDDODDDT
TDDDDDDDDODDODDODOODDDDDDDDDODOVDDDODDOT
TDVDDDDODDDDDDDDDDDDDDDDDODDODDDDODDDODT
TTTTTTTTTTTTTTTTTTTTTTTTTTTTTTTTTTTTTTTT