TTTTTTTTTTTTTTTTTTTTTTTTTTTTTTTTTTTTTTTT
TDDDDDD9DDVDO9DDDDDODODDDDDDD9DDDDODDDDT
TDOPODDDDDD9DDDDDDDDDOVDDODDDD9DDDDD9DDT
TDDDDDDDDDD9DD9DDDDDODODDODDDDDDDDODDDDT
TOD99DDDDDDDDDODDDDDDODDODDDDODDDODDDDDT
TODOODDDDDDDDDOODDODDDDDDDDODDDDDDODO9DT
TDDDODDODDDDDDDDODDDDDOD9ODDDDDDDDODOODT
TTTTTTTTTTTTTTTTTTTTTTTTTTTTTTTDDDODDODT
TD9DDDODDVD9DDODODDDDDDDDDDVDO9DDDDDDODT
TDDVDDDDDODDDDD9DDDDDDDDO99ODDVDDDDODDDT
TDDDODDODODDDDDDDDDDDDDDOODODDODDDDDDDDT
TD9DDDDDODDDDDDDDOO9DDDDDDDODDODVDDDD9DT
TDODD9DDOD99DDDDDODOVDDVDDDDODDDODDVDODT
TDVODDDDDDDDDDDDDDOOODDODDDDDDDDVDDDDDOT
TDDDDDDDDTTTTTTTTTTTTTTTTTTTTTTTTTTTTTTT
T99DDDDDDDDD9DDDVDDDDODDDDDODDDODDDDDDDT
TO9DDDDDDDDDOODDODDDDDDDDODDDDDDODO9DDET
TDODDODDDDDDDDODDDDDOD99DDDDVDDDODOODDDT
TDDDDOVDD9DDDDDDDDODDDDDDODOVDDDDDDODDDT
TDDD9DD9DODDODOODDDDDDDDDODOVDDDDDDODDOT
TDVDDDDODDDDD9DDDDDDDDD9DODDODDDDODDDODT
TTTTTTTTTTTTTTTTTTTTTTTTTTTTTTTTTTTTTTTT