TTTTTTTTTTTTTTTTTTTTTTTTTTTTTTTTTTTTTTTT
TPZZOZVZOZVZOZVZOZVZOZVZZZZZZZZZZZZZZZZT
TZZZDZDZDZDZDZDZDZDZOZVZZZZZZZZZZZZZZZZT
TZZZMZMZVZOZVZOZVZOZOZVZZZZZZZZZZZZZZZZT
TZZZZZZZDZDZDZDZDZDZOZVZZZZZZZZZZZZZZZZT
TZZZTZTZMZMZMZMZOZVZOZVZZZZZZZZZZZZZZZZT
TZZZZZZZZZZZZZZZDZDZOZVZZZZZZZZZZZZZZZZT
TZZZZZZZZZZZDZDZMZMZOZVZZZZZZZZZZZZZZZZT
TZZZZZZZTZTZZZZZZZZZOZVZZZZZZZZZZZZZZZZT
TZZZZZZZZZZZZZZZTZTZDZDZZZZZZZZZZZZZZZZT
TZZZZZZZZZZZZZZZZZZZMZMZZZZZZZZZZZZZZZZT
TZZZZZZZZZZZZZZZZZZZZZZZZZZZZZZZZZZZZZZT
TZZZZZZZZZZZZZZZZZZZZZZZZZZZZZZZZZZZZOOT
TZZZZZZZZZZZZZZZZZZZZZZZZZZZZZZZZZZZZDDT
TZZZOZVZZZZZZZZZZZZZZZZZZZZZZZZZZZZZZOOT
TZZZDZDZZZZZZZZZZZZZZZZZZZZZZZZZZZZZZDDT
TZZZZZZZZZZZZZZZZZZZZZZZZZZZZZZZZZZZZOOT
TZZZZZZZZZZZZZZZZZZZZZZZZZZZZZZZZZZZZDDT
TZZZRZRZZZZZZZZZZZZZZZZZZZZZZZZZZZZZZZZT
TZZZZZZZZZZZZZZZZZZZZZZZZZZZZZZZZZZZZZZT
TZZZZZZZZZZZZZZZZZZZZZZZZZZZZZZZZZZZZMZT
TTTTTTTTTTTTTTTTTTTTTTTTTTTTTTTTTTTTTZMT