TTTTTTTTTTTTTTTTTTTTTTTTTTTTTTTTTTTTTTTT
TPDDDDDODDDDDDDDDDDDDDDDDDDDODDDDDDDDODT
TDDDDDODDDDDDDDDDDDDDODDDDDDDDDDDDDDDDDT
TDDDDDDDDODDODDDDDDDDDDDDDDDDDDDDDDDDDDT
TODDDDDDDDDDDDDDDDDDDDDDDDDDDDDDDDDDDDDT
TDDDDDDDDDDDDDDDDDDDODDDDDDDDDDDDDDDDDDT
TDODDDDDDDDDDDDDDDDDDDDDODDDDDDDDDODDDDT
TDDODDDDDODDDDDDDDDDDODDODDDDDDDDDDDDDOT
TDDDDDDODDDDDDODDDDDDDDDDDDDDDDDDDDDODDT
TDDDDDDDD9WDDDODD9WDDDDDD9WDDDDDD9WDDDDT
TDDDDDDDD99DDDODD99DDDDDD99DDDDDD99DODDT
TDDDDDDDDDDDDDDDDDDDDDDDDDDDDDDDDDDDDDDT
TDDDODDDDDDDDDDDDDDDDDDDDDDDDDDDDDDODDDT
TDDDODDDDDODDDDDDDDDDDDDDDDDDDDDDDDDDDDT
TDDDDDDODDDDDDDDDDDODDDDDDDDDDDDDDDDDDOT
TDDDDDDDDDDDODDDDDDDODDDDDDDDDDDDDDDDDDT
TDDODDDDDDDDDDDDDDODDDDDDDDDDDDDDDDDDDDT
TDDDDDDDDDDDDDDDDDDDDDODDDDDDDDDODDDDDDT
TDDDDDDDDDDDDDDDDDDDDDDDDDDDDDDDDODDODDT
TDDDDODDDDDDODOODDDDDDDDDDDDDDDDDDODDDDT
TDDDDDDDDDDDODOODDDDDDDDDODDODODDDDDVVET
TTTTTTTTTTTTTTTTTTTTTTTTTTTTTTTTTTTTTTTT
2
300
50
5